sudden - странный, неожиданно
condition - условие
where are u going with this? - ты к чему клонишь?
to suppose - предполагать
to assume - преплолагать
probavly - возможно 
to suffer - страдать
enlightened - просвяшённый
vastly - в значительной степени
vast - огромный
honestly - честно говоря
to offend - обижать
exactly - точно, именно
equal - равный
how i now - откуда я знаю
accutrement - атрибуты
flair for - талант
reference - отсылка
look down - смотреть с высока
to dig - копать, любить
certain point - определённый момент
to tie - связывать
to be after smth - охотиться за чем то
to frighten - напугать
to arrange - организовать
to note - обратить внимание
to rins out - прополаскивать
rather - скорее
to spy - подглядывать
affair - дело
all along - все время
to show up - обьявляться, приходить
it's safe to say - смело можно сказать
to apply - подавать заявление
livin' my dream - живу мечтой
to consider oneself - считать когото каким то
exception - исключение
except for - за исключением
it's absolute winning thing thats i have - лучшая вещь что у меня есть
conduct - проводить
to buck the trend - плыть против течения
curtsy - приседание
something along those lines - чтото в этом духе
to struggle - бороться
instead of - вместо чего либо
to capture - захватывать
out of nowhere - внезаптно из неоткуда
to hut a home run - сделать чтото прям афигенно
gratifying - хороший, удовлетворяющий
baby steps - потехонечку
premise - задумка такая
odd - странный 
not give a shit - плевать, пофиг
despite - несмотря
dignity- достоинство
pass - проходить передавать 
evidantly - очевидно
stick somth up - засовывать чтото
shady things - мутные штуки
to work out - понять, разобраться
up someone's sleeve - как козырь в рукаве
get to be - стать кемто 
get rid of smth - уизбавиться от чего то
amount of time - промежуток времени
newfound - новобреобретенный
fury - гнев
thankfully - слава богу
rivaly - конкуренция
incapable - неспособный
trademark - торавный знак, фишка
without strings - без задолженностей, без обязательств
hook up - пикапить, флиртовать
i'll be right back - Я скоро вернусь
come up with something - Придумывать что-то
must have slipped my mind - должно быть выскользнуло из головы
why, if it isn't - кто же это если не(о мой бог это же)
awful - плохо
summon - вызывать
figure out - вычислять, выяснять
convince - убеждать, уверять
eventually - в конце концов, в итоге
favor - услуга, делать услугу
what are you up to? - what are you doing? 
opportunity - возможность
look forward - ждать с нетерпением
suggest - предлагать
likewise - in the same way(так же, я тоже)
on the subject of smth - по теме чего либо(касаемо чего либо)
deliberately - умышленно
disobeyed - ослушался
obey - подчиняться
towards - в направлении, в отношении к чему-нибудь
don't concern me - не беспокоит меня 
deprecated - устарел