przez(пшэз) - через
tylko(ти/ылько) - только
tego(тэго) - того
sobie(собе) - себе
jeszcze(ешче) - ещё
moze(може) - может
kiedy(кеды) - когда
gdy(гды) - когда/если
teraz(тераз) - сейчас
ten(тэн) - тот/этот
ktory(ктурэ) - какой/который
nawet(навэт) - даже
bardzo(бардзо) - очень
przed(пшэд) - перед
tu(ту) - здесь
jednak(еднак) - однако/всё таки
cos(цощ) - что-то
wszystko(вшискто) - всё
przy(пши) - около
wiec(венц) - поэтому
nic(ниц) - ничего
zeby(жебы) - чтобы
mial(мяу) - он имел
byc(би/ыць) - быть
potem(потэм) - потом
tez(тэж) - тоже
jesli(ешли) - если
gdzie(гджэ) - где
lecz(лэчш) - но
siebie(ш/щебе) - себя
nigdy(нигды) - никогда
wlasnie(уощне) - как-раз
dobrze(добже) - хорошо
oczy(очы) - глаза
zawsze(завше) - всегда
wtedy(втеды) - тогда
przeciez(пшэчеш) - но же/даже
drzwi(джви) - дверь
chyba(хиба) - наверное
nagle(нагле) - неожиданно
wscyscy(вшисцы) - все
sposob(способ) - способ
czas(час) - время
kilka(килька) - несколько
razem(разем) - вместе
takze(также) - также
nikt(никт) - никто
wiele(веле) - много
ktos(ктощ) - кто-то
trzeba(тшэба) - нужно
znac(знач) - знать
moge(моге) - могу
wejsc(вейшч) - войти
pamienc(паменч) - память
nareszcie(нарешце) - наконец-то
przeconac(пшеконач) - убедить
udzial(удяу) - участие
kolejny(колэйны) - следующий
swietnie(щветне) - отлично
ostatecznie(остатэчне) - окончательно
zdanie(здание) - мнение
rozmawiac(розмавяч) - разговаривать/беседовать
istotnie(истотне) - значительно
otoz(отуж) - вот
reka(рэнька) - рука
niedawno(недавно) - недавно
plecy(плэци) - спина
duzy(дужэ) - большой
corka(цурка) - дочь
slad(щлад) - след
piecdziesiat(пенджесёнт) - пятьдесят
ostro(остро) - остро/резко/серьёзно
dookola(доокоуа) - вокруг
nigdzie(нигджэ) - нигде
noz(нуж) - нож
jechac(ехач) - ехать
ciotka(чотка) - тётя
nowo(ново) - вновь
dotychczas(дотыхчас) - до сих пор
krzyk(кшик) - крик
zadanie(задане) - задание
ksztalt(кштаут) - форма/вид/фигура
wierzyc(вежыч) - верить
posrod(пощруд) - посреди
facet(фацет) - парень/мужчина
zachod(захуд) - запад/закат
lekarz(лэкаж) - врач
poczucie(почуче) - чувство/ощущение
obecnosc(обэчношч) - присутствие
polnoc(пууноц) - север/полночь
znaczenie(значэне) - значение/смысл
rodzina(роджина) - семья
ukryc(укрыч) - укрыть/скрыть/спрятать
zal(жал) - сожаление/горе/печаль
zatrzymac(затшимач) - задержать/остановить
liczec(личач) - считать/расчитывать
zimno(жимно) - холодно
lagodnie(уагодне) - нежно
tysiac(тыщёнц) - тысяча
zmienic(зменич) - изменить/переменить/сменить
korytarz(коритаж) - коридор
przepraszam(пшэпрэшам) - извините
prosze(проше) - пожалуйста
pasuje(пасуе) - подходит
pzrykro mi(пшикро ми) - мне жаль
zaraz wracam(зараз врацам) - я сейчас вернусь
trzymaj sie(тшимай сие) - держись
powodzenia(поводзэння) - удачи
szybkiego powrotu do zdrowia(шипкего повроту до здровея) - скорого выздоровления
brzmi dobzre(бжми добже) - звучит хорошо
obojetnie(обоентне) - без разницы
w porzadku(в пожондку) - в порядке
niezle(нежьле) - неплохо
jak najbardziej(як найбарджей) - конечно
zastanowie sie(застановье ще) - я подумаю
bez pzresady(беж пшесады) - без преувеличений
w czym moge pomoc?(в чым могэ помоц?) - чем могу помочь?
nie ma za co(ние ма за цо) - не за что
nie szkodzi(ние щкодзи) - ничего страшного
dobzre wiedziec(добже виеджець) - хорошоя информация
kojazre(кояжэ) - припоминаю
cholera jasna(холэра ясна) - блять(в мягкой форме, типо 'блин')(ругательство)